0011011111
0111?10011
0001010001
1101010001
11?0011001
1110001001
1110001001
1110?01001
1010101101
1011?00110